X X X X X
X X > V X
R > ^ > >
X X X X X
X X X X X